他说她喜欢自己。	He says she likes herself.
他说她厌恶自己。	He said she hated herself.
他说她帮助自己。	He said she helped herself.
他说她相信自己。	He said she believed in herself.
他说她支持自己。	He said she supported herself.
他说她欺骗自己。	He said she lied to herself.
他说她安慰自己。	He said she comforted herself.
他说她挑战自己。	He said she challenged herself.
他说她鄙视自己。	He said she despised herself.
他说她忽略自己。	He said she ignored herself.
他说她原谅自己。	He says she forgives herself.
他说她怀疑自己。	He said she suspected herself.
他说她超越自己。	He says she's better than herself.
他说她设计自己。	He said she designed herself.
他说她讨厌自己。	He said she hates herself.
他说她介绍自己。	He said she introduced herself.
他说她夸奖自己。	He said she complimented herself.
他说她改造自己。	He said she changed herself.
他说她结束自己。	He said she ended herself.
他说她解放自己。	He said she freed herself.
他说她刺激自己。	He says she stimulates herself.
他说她考虑自己。	He said she thought about herself.
他说她掐自己。	He said she strangled herself.
他说她评论自己。	He said she commented on herself.
他说她爱惜自己。	He said she loved herself.
他说她爱护自己。	He said she loved herself.
他说她爱自己。	He said she loved herself.
他说她保护自己。	He said she protected herself.
他说她改正自己。	He said she corrected herself.
他说她谈论自己。	He said she talked about herself.
他说她维护自己。	He said she defended herself.
他说她牺牲自己。	He said she sacrificed herself.
他说她重复自己。	He said she repeated herself.
他说她抓自己。	He said she grabbed herself.
他说她指着自己。	He said she was pointing at herself.
他说她锻炼自己。	He said she worked out herself.
他说她打自己。	He said she hit herself.
他说她操心自己。	He said she was worried about herself.
他说她纠正自己。	He said she corrected herself.
他说她扎自己。	He said she stuck herself.
他说她谈到自己。	He said she talked about herself.
他说她证明自己。	He said she proved herself.
他说她训练自己。	He said she trained herself.
他说她依靠自己。	He says she's on her own.
他说她优待自己。	He said she treated herself well.
他说她鞭策自己。	He says she whips herself.
他说她尊重自己。	He said she respected herself.
他说她辜负自己。	He said she failed herself.
他说她担心自己。	He said she was worried about herself.
他说她控制自己。	He said she controlled herself.
