她说他喜欢自己。	She says he likes himself.
她说他厌恶自己。	She said he hated himself.
她说他帮助自己。	She said he helped himself.
她说他相信自己。	She said he believed in himself.
她说他支持自己。	She said he supported himself.
她说他欺骗自己。	She said he lied to himself.
她说他安慰自己。	She said he comforted himself.
她说他挑战自己。	She said he challenged himself.
她说他鄙视自己。	She said he despised himself.
她说他忽略自己。	She said he ignored himself.
她说他原谅自己。	She says he forgives himself.
她说他怀疑自己。	She says he suspects himself.
她说他超越自己。	She said he was ahead of himself.
她说他设计自己。	She said he designed himself.
她说他讨厌自己。	She said he hated himself.
她说他介绍自己。	She said he introduced himself.
她说他夸奖自己。	She said he complimented himself.
她说他改造自己。	She said he changed himself.
她说他结束自己。	She said he ended himself.
她说他解放自己。	She said he freed himself.
她说他刺激自己。	She says he stimulates himself.
她说他考虑自己。	She said he thought about himself.
她说他掐自己。	She said he strangled himself.
她说他评论自己。	She said he commented on himself.
她说他爱惜自己。	She said he loved himself.
她说他爱护自己。	She said he loved himself.
她说他爱自己。	She said he loved himself.
她说他保护自己。	She said he protected himself.
她说他改正自己。	She said he corrected himself.
她说他谈论自己。	She said he talked about himself.
她说他维护自己。	She says he defends himself.
她说他牺牲自己。	She said he sacrificed himself.
她说他重复自己。	She said he repeated himself.
她说他抓自己。	She said he grabbed himself.
她说他指着自己。	She said he was pointing at himself.
她说他锻炼自己。	She said he worked out himself.
她说他打自己。	She said he hit himself.
她说他操心自己。	She said he was worried about himself.
她说他纠正自己。	She said he corrected himself.
她说他扎自己。	She said he stuck himself.
她说他谈到自己。	She said he talked about himself.
她说他证明自己。	She said he proved himself.
她说他训练自己。	She said he trained himself.
她说他依靠自己。	She says he's on his own.
她说他优待自己。	She said he treated himself well.
她说他鞭策自己。	She says he whips himself.
她说他尊重自己。	She said he respected himself.
她说他辜负自己。	She said he failed himself.
她说他担心自己。	She said he was worried about himself.
她说他控制自己。	She says he controls himself.
