她说我喜欢自己。	She said I like myself.
他说我喜欢自己。	He said I like myself.
她说我厌恶自己。	She said I hated myself.
他说我厌恶自己。	He said I hated myself.
她说我帮助自己。	She said I helped myself.
他说我帮助自己。	He said I helped myself.
她说我相信自己。	She said I believed in myself.
他说我相信自己。	He said I believed in myself.
她说我支持自己。	She said I supported myself.
他说我支持自己。	He said I supported myself.
她说我欺骗自己。	She said I lied to myself.
他说我欺骗自己。	He said I lied to myself.
她说我安慰自己。	She said I comforted myself.
他说我安慰自己。	He said I comforted myself.
她说我挑战自己。	She said I challenged myself.
他说我挑战自己。	He said I challenged myself.
她说我鄙视自己。	She said I despised myself.
他说我鄙视自己。	He said I despised myself.
她说我忽略自己。	She said I ignored myself.
他说我忽略自己。	He said I ignored myself.
她说我原谅自己。	She said I forgive myself.
他说我原谅自己。	He said I forgive myself.
她说我怀疑自己。	She said I suspected myself.
他说我怀疑自己。	He said I suspected myself.
她说我超越自己。	She says I'm beyond myself.
他说我超越自己。	He says I'm above myself.
她说我设计自己。	She said I designed myself.
他说我设计自己。	He said I designed myself.
她说我讨厌自己。	She said I hated myself.
他说我讨厌自己。	He said I hated myself.
她说我介绍自己。	She said I introduced myself.
他说我介绍自己。	He said I introduced myself.
她说我夸奖自己。	She said I complimented myself.
他说我夸奖自己。	He said I complimented myself.
她说我改造自己。	She said I changed myself.
他说我改造自己。	He said I changed myself.
她说我结束自己。	She said I ended up by myself.
他说我结束自己。	He said I ended up by myself.
她说我解放自己。	She said I freed myself.
他说我解放自己。	He said I freed myself.
她说我刺激自己。	She said I was stimulating myself.
他说我刺激自己。	He said I was stimulating myself.
她说我考虑自己。	She said I thought about myself.
他说我考虑自己。	He said I thought about myself.
她说我掐自己。	She said I strangled myself.
他说我掐自己。	He said I strangled myself.
她说我评论自己。	She said I commented on myself.
他说我评论自己。	He said I commented on myself.
她说我爱惜自己。	She said I loved myself.
他说我爱惜自己。	He said I loved myself.
她说我爱护自己。	She said I loved myself.
他说我爱护自己。	He said I loved myself.
她说我爱自己。	She said I loved myself.
他说我爱自己。	He said I loved myself.
她说我保护自己。	She said I protected myself.
他说我保护自己。	He said I protected myself.
她说我改正自己。	She said I corrected myself.
他说我改正自己。	He said I corrected myself.
她说我谈论自己。	She said I was talking about myself.
他说我谈论自己。	He said I was talking about myself.
她说我维护自己。	She said I defended myself.
他说我维护自己。	He said I defended myself.
她说我牺牲自己。	She said I sacrificed myself.
他说我牺牲自己。	He said I sacrificed myself.
她说我重复自己。	She said I repeated myself.
他说我重复自己。	He said I repeated myself.
她说我抓自己。	She said I caught myself.
他说我抓自己。	He said I caught myself.
她说我指着自己。	She said I was pointing at myself.
他说我指着自己。	He said I was pointing at myself.
她说我锻炼自己。	She said I practiced myself.
他说我锻炼自己。	He said I practiced myself.
她说我打自己。	She said I hit myself.
他说我打自己。	He said I hit myself.
她说我操心自己。	She said I was worried about myself.
他说我操心自己。	He said I was worried about myself.
她说我纠正自己。	She said I corrected myself.
他说我纠正自己。	He said I corrected myself.
她说我扎自己。	She said I stuck myself.
他说我扎自己。	He said I stuck myself.
她说我谈到自己。	She said I spoke to myself.
他说我谈到自己。	He said I talked to myself.
她说我证明自己。	She said I proved myself.
他说我证明自己。	He said I proved myself.
她说我训练自己。	She said I trained myself.
他说我训练自己。	He said I trained myself.
她说我依靠自己。	She says I'm on my own.
他说我依靠自己。	He says I'm on my own.
她说我优待自己。	She said I treated myself well.
他说我优待自己。	He said I treated myself well.
她说我鞭策自己。	She says I whip myself.
他说我鞭策自己。	He says I whip myself.
她说我尊重自己。	She said I respected myself.
他说我尊重自己。	He said I respected myself.
她说我辜负自己。	She said I failed myself.
他说我辜负自己。	He said I failed myself.
她说我担心自己。	She said I was worried about myself.
他说我担心自己。	He said I was worried about myself.
她说我控制自己。	She said I control myself.
他说我控制自己。	He said I control myself.
