他说她诬陷自己。	He said she framed herself.
他说她拥抱自己。	He said she hugged herself.
他说她离开自己。	He said she left herself.
他说她打扰自己。	He said she was disturbing herself.
他说她超过自己。	He says she's over herself.
他说她忘了自己。	He said she forgot herself.
他说她回答自己。	He said she answered herself.
他说她表扬自己。	He said she praised herself.
他说她反对自己。	He said she was against herself.
他说她调查自己。	He said she was investigating herself.
他说她拜访自己。	He said she visited herself.
他说她偷听自己。	He said she was eavesdropping on herself.
他说她暗恋自己。	He said she had a crush on herself.
他说她邀请自己。	He said she invited herself.
他说她等待自己。	He said she waited for herself.
他说她嫉妒自己。	He said she was jealous of herself.
他说她羡慕自己。	He said she envied herself.
他说她搭讪自己。	He said she talked to herself.
他说她监视自己。	He said she was watching herself.
他说她吵醒自己。	He said she woke herself up.
他说她激怒自己。	He said she pissed herself off.
他说她模仿自己。	He said she mimics herself.
他说她欺负自己。	He said she bullied herself.
他说她追随自己。	He said she followed herself.
他说她回避自己。	He said she avoided herself.
他说她思念自己。	He said she missed herself.
他说她仰慕自己。	He said she admired herself.
他说她冷落自己。	He said she was cold to herself.
他说她靠近自己。	He said she was close to herself.
他说她辅导自己。	He said she tutored herself.
他说她干扰自己。	He said she interfered with herself.
他说她加入自己。	He said she joined herself.
他说她接近自己。	He said she was close to herself.
他说她看望自己。	He said she looked at herself.
他说她捞自己。	He said she fished herself.
他说她欢迎自己。	He said she welcomed herself.
他说她勾引自己。	He said she seduced herself.
他说她勾结自己。	He said she colluded with herself.
他说她等自己。	He said she waited for herself.
他说她等候自己。	He said she waited for herself.
他说她挤自己。	He said she squeezed herself.
他说她排挤自己。	He said she was crowding herself.
他说她欺压自己。	He said she was bullying herself.
他说她探望自己。	He said she visited herself.
他说她信任自己。	He said she trusted herself.
他说她响应自己。	He said she responded to herself.
他说她学习自己。	He said she studied herself.
他说她咬自己。	He said she bit herself.
他说她消灭自己。	He said she wiped herself out.
他说她追赶自己。	He said she was chasing herself.
他说她追求自己。	He said she was after herself.
他说她阻挡自己。	He said she stopped herself.
他说她孝敬自己。	He said she was kind to herself.
他说她赢自己。	He said she beat herself.
他说她招呼自己。	He said she'd take care of herself.
他说她指导自己。	He said she coached herself.
他说她支援自己。	He said she supported herself.
他说她替换自己。	He said she replaced herself.
他说她通知自己。	He said she informed herself.
他说她吸引自己。	He said she attracted herself.
他说她影响自己。	He said she influenced herself.
他说她杀害自己。	He said she killed herself.
他说她赔偿自己。	He says she's paying for herself.
他说她衬托自己。	He said she took care of herself.
他说她扣留自己。	He said she detained herself.
他说她恐吓自己。	He said she threatened herself.
他说她联络自己。	He said she contacted herself.
他说她忍受自己。	He said she put up with herself.
他说她请示自己。	He said she asked for it herself.
他说她算计自己。	He says she's trying to figure it out herself.
